{"levels":[{
	"field":[
		[3,3,7,0,0,0,0,0,3,0,4,3],
		[0,0,0,7,0,0,3,0,0,0,0,0],
		[0,7,0,0,3,0,0,12,0,0,0,0],
		[0,13,3,0,0,0,0,0,0,3,0,0],
		[0,3,0,0,0,0,0,5,6,0,0,5],
		[0,14,0,0,0,0,0,4,7,0,0,4],
		[6,4,2,0,0,0,0,0,0,4,0,0],
		[0,0,7,0,0,0,0,0,0,0,0,0],
		[0,0,0,5,0,7,0,0,0,0,0,0],
		[0,0,3,0,0,0,0,0,0,0,0,4],
		[6,0,0,0,0,0,0,0,0,3,0,0],
		[0,0,5,0,0,0,0,0,3,0,0,0],
		[0,0,7,0,0,0,0,0,0,7,0,5],
		[6,0,0,11,0,3,1,0,0,0,0,0],
		[0,0,7,0,0,0,5,0,0,0,0,3],
		[6,0,0,0,0,0,4,3,0,0,6,0],
		[0,0,0,0,0,3,0,0,0,0,0,5],
		[3,0,0,0,7,0,0,0,3,0,0,0],
		[0,6,0,3,0,0,5,6,0,0,0,5]
	],
	"indices":["","","end","block","cornerTR","cornerTL","cornerBL","cornerBR","","","","teleC:2:7","teleC:13:3","teleM:5:1","teleM:3:1"],
	"x0":13,
	"y0":6
},{
	"field":[
		[0,0,0,3,7,0,11,0,0,3,0,0],
		[3,0,0,0,0,0,0,0,0,0,0,4],
		[3,1,0,0,0,0,0,0,0,0,4,0],
		[0,0,0,0,0,0,0,2],
		[7,0,0,0,0,3,0,0,0,3],
		[0,3,0,0,0,0,0],
		[0,0,0,0,0,0,0,0,3],
		[6,0,0,0,0,0,0,3,0,0,5],
		[0,0,3,0,0,0,0,0,0,0,3],
		[0,7,0,0,0,0,0,0,0,0,4],
		[0],
		[0,0,0,0,3,0,0],
		[6,0,0,0,0,0,0],
		[0,0,0,0,3,0,0,12,0,0,3],
		[0,3,0,0,0,0,4],
		[0,0,0,0,0,0,0,0,0,5,0,3],
		[0,0,0,3,0,0,0],
		[6,0,0,0,0,0,0,0,0,0,0,5],
		[3,0,3,0,3,0,5,3,0,0,0,3]
	],
	"indices":["","","end","block","cornerTR","cornerTL","cornerBL","cornerBR","","","","teleC:13:7","teleC:0:6"],
	"x0":2,
	"y0":1
}
],"canScroll":1
}
	
